22222222222222222222222222222222222222222222222222222222222222222222222222222222222222222222222222222222222222222222222222222222222222222
22222222222222222222222222222222222222222222222222222222222222222222222222222222222222222222222222222222222222222222222222222222222222222
22222222222222222222222222222222222222222222222222222222222222222222222222222222222222222222222222222222222222222222222222222222222222222
22222222222222222222222222222222222222222222222222222222222222222222222222222222222222222222222222222222222222222222222222222222222222222
22222222222222222222222222222222222222222222222222222222222222222222222222222222222222222222222222222222222222222222222222222222222222222
22222222222222222222222222222222222222222222222222222222222222222222222222222222222222222222222222222222222222222222222222222222222222222
22222222222222222222222222222222222222222222222222222222222222222222222222222222222222222222222222222222222222222222222222222222222222222
22222222222222222222222222222222222222222222222222222222222222222222222222222222222222222222222222222222222222222222222222222222222222222
22222222222222222222222222222222222222222222222222222222222222222222222222222222222222222222222222222222222222222222222222222222222222222
22222222222222222222222222222222222222222222222222222222222222222222222222222222222222222222222222222222222222222222222222222222222222222
22222222222222222222222222222222222222222222222222222222222222222222222222222222222222222222222222222222222222222222222222222222222222222
22222222222222222222222222222222222222222222222222222222222222222222222222222222222222222222222222222222222222222222222222222222222222222
22222222222222222222222222222222222222222222222222222222222222222222222222222222222222222222222222222222222222222222222222222222222222222
22222222222222222222222222222222222222222222222222222222222222222222222222222222222222222222222222222222222222222222222222222222222222222
22222222222222222222222222222222222222222222222222222222222222222222222222222222222222222222222222222222222222222222222222222222222222222
22222222222222222222222222222222222222222222222222222222222222222222222222222222222222222222222222222222222222222222222222222222222222222
22222222222222222222222222222222222222222222222222222222222222222222222222222222222222222222222222222222222222222222222222222222222222222
22222222222222222222222222222222222222222222222222222222222222222222222222222222222222222222222222222222222222222222222222222222222222222
22222222222222222222222222222222222222222222222222222222222222222222222222222222222222222222222222222222222222222222222222222222222222222
22222222222222222222222222222222222222222222222222222222222222222222222222222222222222222222222222222222222222222222222222222222222222222
22222222222222222222222222222222222222222222222222222222222222222222222222222222222222222222222222222222222222222222222222222222222222222
22222222222222222222222222222222222222222222222222222222222222222222222222222222222222222222222222222222222222222222222222222222222222222
222222222222222222222222222222222222222222222222222222222222222222222222222222222222......22222..............22222......22222222222222222
2222222222222222222222222222222222222222222222222222222222222222222222222222222222.........................................22222222222222
22222222222222222222222222222222222222222222222222222222222222222222222222222222.............................................222222222222
222222222222222222222222222222222222222222222222222222222222222222222222222222.................................................2222222222
22222222222222222222222222222222222222222222222222222222222222222222222222222...................................................222222222
2222222222222222222222222222222222222222222222222222222222222222222222222222.....................................................22222222
222222222222222222222222222222222222222222222222222222222222222222222222222.......................................................2222222
22222222222222222222222222222222222222222222222222222222222222222222222222.........................................................222222
2222222222222222222222222222222222222222222222222222222222222222222222222...........................................................22222
222222222222222222222222222222222222222222222222222222222222222222222222.............................................................2222
222222222222222222222222222222222222222222222222222222222222222222222222.............................................................2222
22222222222222222222222222222222222222222222222222222222222222222222222...............................................................222
22222222222222222222222222222222222222222222222222222222222222222222222...............................................................222
2222222222222222222222222222222222222222222222222222222222222222222222.................................................................22
2222222222222222222222222222222222222222222222222222222222222222222222.................................................................22
222222222222222222222222222222222222222222222222222222222222222222222..................................................................22
222222222222222222222222222222222222222222222222222222222222222222222..................................................................22
222222222222222222222222222222222222222222222222222222222222222222222..................................................................22
222222222222222222222222222222222222222222222222222222222222222222222..................................................................22
222222222222222222222222222222222222222222222222222222222222222222222..................................................................22
222222222222222222222222222222222222222222222222222222222222222222222.....................2.......................2....................22
222222222222222222222222222222222222222222222222222222222222222222222.....................2.......................2....................22
222222222222222222222222222222222222222222222222222222222222222222222..................................................................22
222222222222222222222222222222222222222222222222222222222222222222222..................................................................22
222222222222222222222222222222222222222222222222222222222222222222222..................................................................22
222222222222222222222222222222222222222222222222222222222222222222222..................................................................22
222222222222222222222222222222222222222222222222222222222222222222222..................................................................22
222222222222222222222222222222222222222222222222222222222222222222222..................................................................22
2222222222222222222222222222222222222222222222222222222222222222222222.................................................................22
22222222222222222222222222222222222222222222222222222222222222222222222...............................................................222
22222222222222222222222222222222222222222222222222222222222222222222222...............................................................222
222222222222222222222222222222222222222222222222222222222222222222222222.............................................................2222
222222222222222222222222222222222222222222222222222222222222222222222222.............................................................2222
2222222222222222222222222222222222222222222222222222222222222222222222222...........................................................22222
22222222222222222222222222222222222222222222222222222222222222222222222222.........................................................222222
222222222222222222222222222222222222222222222222222222222222222222222222222.......................................................2222222
2222222222222222222222222222222222222222222222222222222222222222222222222222.....................................................22222222
22222222222222222222222222222222222222222222222222222222222222222222222222222...................................................222222222
222222222222222222222222222222222222222222222222222222222222222222222222222222.................................................2222222222
222222222222222222222222222222222222222222222222222222222222222222222222222222222...........................................2222222222222
222222222222222222222222222222222222222222222222222222222222222222222222222222222222................222222...............2222222222222222
22222222222222222222222222222222222222222222222222222222222222222222222222222222222222222222222222222222222222222222222222222222222222222
22222222222222222222222222222222222222222222222222222222222222222222222222222222222222222222222222222222222222222222222222222222222222222
22222222222222222222222222222222222222222222222222222222222222222222222222222222222222222222222222222222222222222222222222222222222222222
22222222222222222222222222222222222222222222222222222222222222222222222222222222222222222222222222222222222222222222222222222222222222222
22222222222222222222222222222222222222222222222222222222222222222222222222222222222222222222222222222222222222222222222222222222222222222
22222222222222222222222222222222222222222222222222222222222222222222222222222222222222222222222222222222222222222222222222222222222222222
22222222222222222222222222222222222222222222222222222222222222222222222222222222222222222222222222222222222222222222222222222222222222222
22222222222222222222222222222222222222222222222222222222222222222222222222222222222222222222222222222222222222222222222222222222222222222
22222222222222222222222222222222222222222222222222222222222222222222222222222222222222222222222222222222222222222222222222222222222222222
22222222222222222222222222222222222222222222222222222222222222222222222222222222222222222222222222222222222222222222222222222222222222222
22222222222222222222222222222222222222222222222222222222222222222222222222222222222222222222222222222222222222222222222222222222222222222
22222222222222222222222222222222222222222222222222222222222222222222222222222222222222222222222222222222222222222222222222222222222222222
22222222222222222222222222222222222222222222222222222222222222222222222222222222222222222222222222222222222222222222222222222222222222222
22222222222222222222222222222222222222222222222222222222222222222222222222222222222222222222222222222222222222222222222222222222222222222
22222222222222222222222222222222222222222222222222222222222222222222222222222222222222222222222222222222222222222222222222222222222222222
22222222222222222222222222222222222222222222222222222222222222222222222222222222222222222222222222222222222222222222222222222222222222222
22222222222222222222222222222222222222222222222222222222222222222222222222222222222222222222222222222222222222222222222222222222222222222
22222222222222222222222222222222222222222222222222222222222222222222222222222222222222222222222222222222222222222222222222222222222222222
22222222222222222222222222222222222222222222222222222222222222222222222222222222222222222222222222222222222222222222222222222222222222222
22222222222222222222222222222222222222222222222222222222222222222222222222222222222222222222222222222222222222222222222222222222222222222
22222222222222222222222222222222222222222222222222222222222222222222222222222222222222222222222222222222222222222222222222222222222222222
22222222222222222222222222222222222222222222222222222222222222222222222222222222222222222222222222222222222222222222222222222222222222222
22222222222222222222222222222222222222222222222222222222222222222222222222222222222222222222222222222222222222222222222222222222222222222
22222222222222222222222222222222222222222222222222222222222222222222222222222222222222222222222222222222222222222222222222222222222222222